5 5
T,2,2,T,2
T,3,3,T,3
3,T,3,2,T
3,T,3,1,1
2,T,2,G,G
