11 11
_,_,1,_,_,1,_,1,_,_,_
2,3,2,2,2,3,2,1,1,1,1
1,3,_,3,_,_,2,_,2,_,2
1,_,_,5,4,_,3,2,3,_,3
1,4,_,_,4,5,_,4,_,6,_
1,4,_,6,_,_,_,6,_,_,_
1,_,_,6,_,_,6,_,_,5,_
2,3,4,_,_,4,_,_,4,3,2
1,_,3,4,3,4,4,5,4,_,1
2,4,_,3,_,2,_,_,_,3,1
1,_,_,3,1,2,2,4,_,2,_
