11 11
T,T,1,G,G,1,T,1,G,G,G
2,3,2,2,2,3,2,1,1,1,1
1,3,T,3,T,T,2,G,2,T,2
1,T,T,5,4,T,3,2,3,T,3
1,4,T,T,4,5,T,4,T,6,T
1,4,T,6,T,T,T,6,T,T,T
1,T,T,6,T,T,6,T,T,5,T
2,3,4,T,T,4,T,T,4,3,2
1,T,3,4,3,4,4,5,4,T,1
2,4,T,3,T,2,T,T,T,3,1
1,T,T,3,1,2,2,4,T,2,G
