5 5
G,1,2,4,T
1,2,T,T,T
3,T,4,3,2
T,T,2,G,G
2,2,1,G,_
